DDDDDGDDDDFFFG
DDAGDDFDDDFFGD
DGFGDDDDDDFFGF
DDFSDDFFDDFDFD
DDDDDDDSSSFFFS
SSSSSSDDDDDDDF
GGGDDDDDDDDDDG
DDDDDDFFFFDDDS
DDFDFDFDFDFDFG
SSSSSSDDDDDDDD
DDDDDDDDDDDDDD