ADSSSGDDDG
DDSGSSGGDD
DGSGSDDDSD
DDSDDDFFSD
DSSSGDDDDD
DDDSSSDDSS
DDDDDDDDSG
DDDDDDDDDD
