DDDDDGSDDA
DSDDDDSDDD
GSDDDDSDDD
SSSSDSSDDD
GGSGDSSDDD
GGFFFFFFFG
